999999999999999999999
999999999999999999999
911111111111111111119
910000000010000000019
913110111010111011319
910000000000000000019
910110101111101011019
910000100010001000019
911110111010111011119
911110100000001011119
911110101141101011119
910000001567100000019
911110101111101011119
911110100000001011119
911110100111001011119
910000000010000000019
913110111010111011319
910010000020000010019
911010101111101010119
910000100010001000019
913111111010111111319
910000000000000000019
911111111111111111119
